"lsoa11cd","date","lsoa11nm","Rural Urban","Tenure: All households; measures: Value","Tenure: Owned; measures: Value","Tenure: Owned: Owned outright; measures: Value","Tenure: Owned: Owned with a mortgage or loan; measures: Value","Tenure: Shared ownership (part owned and part rented); measures: Value","Tenure: Social rented; measures: Value","Tenure: Social rented: Rented from council (Local Authority); measures: Value","Tenure: Social rented: Other; measures: Value","Tenure: Private rented; measures: Value","Tenure: Private rented: Private landlord or letting agency; measures: Value","Tenure: Private rented: Other; measures: Value","Tenure: Living rent free; measures: Value"
"E01006512",2011,"Liverpool 031A","Total",799,161,84,77,9,220,14,206,401,367,34,8
"E01006513",2011,"Liverpool 060A","Total",909,115,55,60,28,131,13,118,625,582,43,10
"E01006514",2011,"Liverpool 037A","Total",1115,108,58,50,6,512,20,492,474,348,126,15
"E01006515",2011,"Liverpool 037B","Total",641,62,17,45,24,402,68,334,140,123,17,13
"E01006518",2011,"Liverpool 044A","Total",835,197,95,102,10,451,48,403,154,135,19,23
"E01006519",2011,"Liverpool 056A","Total",514,474,249,225,1,10,2,8,28,26,2,1
"E01006520",2011,"Liverpool 043A","Total",1182,196,62,134,1,360,13,347,619,600,19,6
"E01006521",2011,"Liverpool 052A","Total",928,389,210,179,0,244,8,236,288,277,11,7
"E01006522",2011,"Liverpool 048A","Total",1094,210,62,148,3,350,19,331,523,499,24,8
"E01006523",2011,"Liverpool 052B","Total",830,258,103,155,6,280,6,274,282,263,19,4
"E01006524",2011,"Liverpool 048B","Total",583,351,191,160,0,15,3,12,207,181,26,10
"E01006525",2011,"Liverpool 049A","Total",486,422,221,201,0,7,5,2,55,42,13,2
"E01006526",2011,"Liverpool 048C","Total",654,473,218,255,2,78,4,74,94,89,5,7
"E01006527",2011,"Liverpool 053A","Total",638,384,181,203,0,179,4,175,71,63,8,4
"E01006528",2011,"Liverpool 052C","Total",613,355,135,220,3,72,15,57,176,168,8,7
"E01006529",2011,"Liverpool 048D","Total",559,431,181,250,2,21,4,17,101,83,18,4
"E01006530",2011,"Liverpool 055A","Total",616,553,324,229,6,11,2,9,40,35,5,6
"E01006531",2011,"Liverpool 055B","Total",674,555,344,211,2,81,9,72,29,26,3,7
"E01006532",2011,"Liverpool 047A","Total",617,559,309,250,0,25,0,25,30,24,6,3
"E01006533",2011,"Liverpool 055C","Total",614,445,251,194,2,112,14,98,47,44,3,8
"E01006534",2011,"Liverpool 054A","Total",649,427,182,245,0,172,38,134,45,43,2,5
"E01006535",2011,"Liverpool 054B","Total",656,452,200,252,1,147,34,113,39,31,8,17
"E01006536",2011,"Liverpool 054C","Total",815,477,203,274,1,240,66,174,84,74,10,13
"E01006537",2011,"Liverpool 055D","Total",964,566,245,321,3,83,7,76,307,296,11,5
"E01006538",2011,"Liverpool 055E","Total",527,429,204,225,2,31,13,18,60,53,7,5
"E01006539",2011,"Liverpool 047B","Total",601,522,283,239,1,8,1,7,68,61,7,2
"E01006540",2011,"Liverpool 024A","Total",771,183,81,102,2,290,17,273,282,259,23,14
"E01006541",2011,"Liverpool 015A","Total",803,435,203,232,1,221,49,172,134,123,11,12
"E01006542",2011,"Liverpool 018A","Total",583,278,123,155,2,142,0,142,155,146,9,6
"E01006543",2011,"Liverpool 015B","Total",509,419,183,236,1,27,3,24,58,50,8,4
"E01006544",2011,"Liverpool 015C","Total",738,225,102,123,1,328,33,295,171,161,10,13
"E01006545",2011,"Liverpool 019A","Total",646,397,175,222,0,18,8,10,220,209,11,11
"E01006546",2011,"Liverpool 019B","Total",583,305,152,153,2,30,7,23,237,231,6,9
"E01006547",2011,"Liverpool 019C","Total",718,265,146,119,5,110,10,100,329,318,11,9
"E01006548",2011,"Liverpool 019D","Total",759,342,173,169,0,93,5,88,306,288,18,18
"E01006549",2011,"Liverpool 043B","Total",949,129,64,65,7,240,21,219,561,557,4,12
"E01006550",2011,"Liverpool 038A","Total",483,168,76,92,4,37,0,37,272,259,13,2
"E01006551",2011,"Liverpool 048E","Total",751,99,51,48,4,520,10,510,118,111,7,10
"E01006552",2011,"Liverpool 039A","Total",869,167,90,77,18,372,20,352,301,284,17,11
"E01006553",2011,"Liverpool 042A","Total",642,263,109,154,3,45,1,44,326,301,25,5
"E01006554",2011,"Liverpool 048F","Total",649,223,92,131,1,107,3,104,316,306,10,2
"E01006556",2011,"Liverpool 039B","Total",1016,130,81,49,3,522,34,488,334,315,19,27
"E01006557",2011,"Liverpool 038B","Total",635,208,110,98,9,28,2,26,385,365,20,5
"E01006558",2011,"Liverpool 018B","Total",739,194,118,76,4,293,27,266,235,233,2,13
"E01006560",2011,"Liverpool 023A","Total",996,145,82,63,2,782,143,639,56,50,6,11
"E01006562",2011,"Liverpool 018E","Total",714,220,123,97,1,333,36,297,150,143,7,10
"E01006563",2011,"Liverpool 024B","Total",908,110,53,57,3,607,88,519,174,172,2,14
"E01006564",2011,"Liverpool 023B","Total",800,441,250,191,2,251,66,185,93,81,12,13
"E01006565",2011,"Liverpool 029A","Total",638,425,200,225,0,146,33,113,59,54,5,8
"E01006566",2011,"Liverpool 032A","Total",577,462,191,271,1,55,22,33,54,51,3,5
"E01006567",2011,"Liverpool 026A","Total",892,334,158,176,0,439,87,352,100,93,7,19
"E01006568",2011,"Liverpool 026B","Total",629,443,140,303,7,99,13,86,78,66,12,2
"E01006569",2011,"Liverpool 029B","Total",613,356,180,176,1,197,62,135,40,33,7,19
"E01006570",2011,"Liverpool 026C","Total",595,454,214,240,1,31,3,28,105,99,6,4
"E01006571",2011,"Liverpool 026D","Total",612,319,136,183,14,225,56,169,49,44,5,5
"E01006572",2011,"Liverpool 025A","Total",501,184,83,101,0,269,81,188,37,37,0,11
"E01006573",2011,"Liverpool 029C","Total",778,347,133,214,3,245,17,228,166,158,8,17
"E01006574",2011,"Liverpool 025B","Total",612,308,133,175,1,246,62,184,56,52,4,1
"E01006575",2011,"Liverpool 034A","Total",578,396,197,199,4,83,33,50,90,85,5,5
"E01006576",2011,"Liverpool 034B","Total",713,601,240,361,0,13,0,13,94,91,3,5
"E01006577",2011,"Liverpool 034C","Total",597,528,248,280,0,5,2,3,54,52,2,10
"E01006578",2011,"Liverpool 036A","Total",554,456,170,286,1,12,1,11,84,77,7,1
"E01006579",2011,"Liverpool 034D","Total",618,569,298,271,0,6,3,3,42,33,9,1
"E01006580",2011,"Liverpool 036B","Total",515,480,233,247,0,6,1,5,24,22,2,5
"E01006581",2011,"Liverpool 036C","Total",607,545,270,275,0,6,1,5,54,45,9,2
"E01006582",2011,"Liverpool 041A","Total",585,523,249,274,1,8,1,7,47,44,3,6
"E01006583",2011,"Liverpool 047C","Total",467,445,246,199,0,4,3,1,14,10,4,4
"E01006584",2011,"Liverpool 034E","Total",611,462,230,232,6,65,7,58,76,72,4,2
"E01006585",2011,"Liverpool 032B","Total",641,257,120,137,0,317,95,222,45,41,4,22
"E01006586",2011,"Liverpool 032C","Total",921,427,169,258,6,236,37,199,233,214,19,19
"E01006587",2011,"Liverpool 032D","Total",717,393,158,235,12,161,4,157,147,141,6,4
"E01006588",2011,"Liverpool 042C","Total",702,429,194,235,1,53,13,40,211,196,15,8
"E01006589",2011,"Liverpool 041B","Total",599,533,235,298,0,19,5,14,39,34,5,8
"E01006590",2011,"Liverpool 042D","Total",701,397,185,212,4,39,3,36,257,241,16,4
"E01006591",2011,"Liverpool 041C","Total",671,470,180,290,1,10,1,9,183,172,11,7
"E01006592",2011,"Liverpool 041D","Total",624,536,290,246,1,9,1,8,72,71,1,6
"E01006593",2011,"Liverpool 042E","Total",662,396,149,247,0,20,2,18,237,222,15,9
"E01006594",2011,"Liverpool 047D","Total",579,509,274,235,2,10,4,6,53,49,4,5
"E01006595",2011,"Liverpool 049B","Total",812,616,276,340,1,43,2,41,147,129,18,5
"E01006596",2011,"Liverpool 049C","Total",597,486,237,249,0,8,2,6,101,95,6,2
"E01006597",2011,"Liverpool 041E","Total",683,583,310,273,0,13,1,12,80,75,5,7
"E01006598",2011,"Liverpool 010A","Total",604,138,64,74,0,416,93,323,45,41,4,5
"E01006599",2011,"Liverpool 010B","Total",482,96,45,51,0,343,110,233,40,35,5,3
"E01006600",2011,"Liverpool 011A","Total",592,320,164,156,2,199,62,137,57,53,4,14
"E01006603",2011,"Liverpool 011B","Total",594,337,176,161,0,203,53,150,43,38,5,11
"E01006604",2011,"Liverpool 016A","Total",571,347,156,191,3,161,63,98,46,42,4,14
"E01006605",2011,"Liverpool 016B","Total",696,314,141,173,2,306,98,208,61,57,4,13
"E01006606",2011,"Liverpool 020A","Total",723,418,174,244,1,154,37,117,143,128,15,7
"E01006607",2011,"Liverpool 008A","Total",641,334,151,183,2,245,65,180,44,39,5,16
"E01006608",2011,"Liverpool 009A","Total",563,294,125,169,14,124,8,116,124,113,11,7
"E01006609",2011,"Liverpool 009B","Total",576,331,145,186,1,101,12,89,137,134,3,6
"E01006610",2011,"Liverpool 009C","Total",669,281,125,156,0,229,12,217,154,146,8,5
"E01006611",2011,"Liverpool 012A","Total",742,267,119,148,0,138,11,127,328,320,8,9
"E01006612",2011,"Liverpool 008B","Total",740,255,113,142,4,415,129,286,52,49,3,14
"E01006613",2011,"Liverpool 009D","Total",611,339,181,158,0,212,52,160,52,44,8,8
"E01006614",2011,"Liverpool 012B","Total",667,326,153,173,2,105,8,97,231,224,7,3
"E01006615",2011,"Liverpool 012C","Total",663,266,109,157,4,167,23,144,211,201,10,15
"E01006616",2011,"Liverpool 015D","Total",613,333,150,183,12,195,59,136,64,62,2,9
"E01006617",2011,"Liverpool 021A","Total",650,457,203,254,1,50,11,39,131,117,14,11
"E01006618",2011,"Liverpool 016C","Total",692,448,218,230,3,184,54,130,49,43,6,8
"E01006619",2011,"Liverpool 021B","Total",734,506,246,260,0,42,11,31,172,158,14,14
"E01006620",2011,"Liverpool 021C","Total",625,458,248,210,0,110,12,98,48,41,7,9
"E01006621",2011,"Liverpool 021D","Total",584,496,260,236,0,22,5,17,57,52,5,9
"E01006622",2011,"Liverpool 021E","Total",586,535,266,269,0,6,1,5,41,40,1,4
"E01006623",2011,"Liverpool 013A","Total",527,494,228,266,0,11,2,9,18,18,0,4
"E01006624",2011,"Liverpool 013B","Total",702,416,160,256,2,158,17,141,117,112,5,9
"E01006625",2011,"Liverpool 016D","Total",609,495,245,250,1,52,8,44,53,49,4,8
"E01006626",2011,"Liverpool 016E","Total",593,467,226,241,4,78,11,67,39,32,7,5
"E01006627",2011,"Liverpool 013C","Total",600,437,201,236,4,86,13,73,61,56,5,12
"E01006628",2011,"Liverpool 052D","Total",651,456,196,260,4,58,1,57,126,118,8,7
"E01006629",2011,"Liverpool 052E","Total",573,376,187,189,1,98,6,92,90,84,6,8
"E01006630",2011,"Liverpool 044B","Total",555,63,23,40,0,424,99,325,55,38,17,13
"E01006632",2011,"Liverpool 044C","Total",884,237,107,130,19,476,70,406,141,131,10,11
"E01006633",2011,"Liverpool 050B","Total",699,153,58,95,3,432,102,330,102,95,7,9
"E01006637",2011,"Liverpool 017A","Total",670,210,66,144,4,363,95,268,85,75,10,8
"E01006638",2011,"Liverpool 017B","Total",518,158,71,87,0,280,74,206,68,65,3,12
"E01006639",2011,"Liverpool 017C","Total",640,411,142,269,3,115,20,95,111,107,4,0
"E01006640",2011,"Liverpool 021F","Total",760,556,260,296,1,113,8,105,81,69,12,9
"E01006641",2011,"Liverpool 025C","Total",633,492,67,425,1,39,11,28,97,84,13,4
"E01006642",2011,"Liverpool 025D","Total",590,210,96,114,2,317,94,223,52,48,4,9
"E01006643",2011,"Liverpool 025E","Total",740,306,115,191,0,324,99,225,101,98,3,9
"E01006644",2011,"Liverpool 017D","Total",963,417,156,261,0,336,78,258,196,183,13,14
"E01006645",2011,"Liverpool 017E","Total",690,208,107,101,3,410,92,318,54,52,2,15
"E01006646",2011,"Liverpool 023C","Total",1006,205,64,141,13,491,75,416,274,262,12,23
"E01006647",2011,"Liverpool 024C","Total",636,87,50,37,10,494,85,409,26,21,5,19
"E01006648",2011,"Liverpool 023D","Total",1075,212,72,140,10,476,79,397,363,347,16,14
"E01006651",2011,"Liverpool 001A","Total",592,525,116,409,0,21,2,19,44,39,5,2
"E01006652",2011,"Liverpool 002A","Total",633,473,211,262,1,14,0,14,134,127,7,11
"E01006653",2011,"Liverpool 001B","Total",656,368,138,230,9,199,56,143,73,65,8,7
"E01006654",2011,"Liverpool 005A","Total",627,380,111,269,0,112,6,106,133,124,9,2
"E01006655",2011,"Liverpool 001C","Total",706,418,189,229,1,172,36,136,106,73,33,9
"E01006656",2011,"Liverpool 002B","Total",669,462,183,279,2,33,3,30,168,154,14,4
"E01006657",2011,"Liverpool 002C","Total",582,336,141,195,0,73,10,63,166,157,9,7
"E01006658",2011,"Liverpool 001D","Total",634,246,121,125,0,301,110,191,74,69,5,13
"E01006659",2011,"Liverpool 005B","Total",548,211,76,135,0,213,40,173,116,110,6,8
"E01006660",2011,"Liverpool 001E","Total",616,318,126,192,0,227,48,179,58,51,7,13
"E01006661",2011,"Liverpool 004A","Total",749,272,112,160,0,376,106,270,73,62,11,28
"E01006662",2011,"Liverpool 004B","Total",785,266,107,159,10,409,79,330,80,76,4,20
"E01006663",2011,"Liverpool 004C","Total",510,247,57,190,3,180,62,118,72,67,5,8
"E01006664",2011,"Liverpool 004D","Total",822,303,120,183,7,314,62,252,190,186,4,8
"E01006665",2011,"Liverpool 007A","Total",630,525,135,390,10,12,1,11,83,76,7,0
"E01006666",2011,"Liverpool 007B","Total",514,444,106,338,15,7,0,7,43,37,6,5
"E01006667",2011,"Liverpool 007C","Total",618,410,156,254,10,134,36,98,58,50,8,6
"E01006668",2011,"Liverpool 007D","Total",590,494,104,390,9,8,1,7,77,71,6,2
"E01006669",2011,"Liverpool 004E","Total",551,411,95,316,9,65,16,49,60,55,5,6
"E01006670",2011,"Liverpool 007E","Total",607,495,171,324,2,34,5,29,71,67,4,5
"E01006671",2011,"Liverpool 013D","Total",499,343,121,222,0,113,41,72,35,29,6,8
"E01006672",2011,"Liverpool 010E","Total",798,309,129,180,4,387,89,298,95,90,5,3
"E01006673",2011,"Liverpool 037D","Total",954,73,31,42,5,598,74,524,263,255,8,15
"E01006674",2011,"Liverpool 039C","Total",826,99,56,43,2,602,123,479,108,98,10,15
"E01006675",2011,"Liverpool 043C","Total",1132,159,88,71,22,423,23,400,514,487,27,14
"E01006676",2011,"Liverpool 044D","Total",761,155,90,65,2,455,67,388,126,110,16,23
"E01006677",2011,"Liverpool 043D","Total",477,83,50,33,1,335,35,300,46,41,5,12
"E01006678",2011,"Liverpool 044E","Total",1059,187,94,93,34,656,87,569,161,155,6,21
"E01006679",2011,"Liverpool 039D","Total",920,93,55,38,7,651,146,505,150,134,16,19
"E01006680",2011,"Liverpool 053B","Total",605,561,284,277,0,15,2,13,26,26,0,3
"E01006681",2011,"Liverpool 054D","Total",719,423,228,195,2,193,59,134,87,78,9,14
"E01006682",2011,"Liverpool 053C","Total",498,465,248,217,0,4,0,4,27,25,2,2
"E01006683",2011,"Liverpool 053D","Total",594,557,295,262,0,10,2,8,24,24,0,3
"E01006684",2011,"Liverpool 056B","Total",999,717,333,384,2,10,1,9,266,250,16,4
"E01006685",2011,"Liverpool 056C","Total",604,489,251,238,0,15,2,13,97,90,7,3
"E01006686",2011,"Liverpool 053E","Total",531,483,257,226,2,7,2,5,32,29,3,7
"E01006687",2011,"Liverpool 056D","Total",933,580,242,338,6,211,25,186,122,106,16,14
"E01006688",2011,"Liverpool 056E","Total",712,447,225,222,2,72,10,62,181,161,20,10
"E01006689",2011,"Liverpool 049D","Total",717,579,257,322,9,43,7,36,79,73,6,7
"E01006690",2011,"Liverpool 028A","Total",801,194,85,109,1,276,19,257,319,304,15,11
"E01006691",2011,"Liverpool 030A","Total",647,210,126,84,5,172,8,164,248,241,7,12
"E01006692",2011,"Liverpool 028B","Total",989,371,175,196,16,255,16,239,336,317,19,11
"E01006693",2011,"Liverpool 024D","Total",838,229,122,107,0,491,60,431,105,96,9,13
"E01006694",2011,"Liverpool 030B","Total",891,219,110,109,2,171,13,158,480,463,17,19
"E01006695",2011,"Liverpool 028C","Total",1029,197,87,110,1,373,30,343,430,420,10,28
"E01006696",2011,"Liverpool 030C","Total",768,260,123,137,7,252,33,219,231,218,13,18
"E01006697",2011,"Liverpool 030D","Total",828,289,153,136,2,145,9,136,372,352,20,20
"E01006698",2011,"Liverpool 012D","Total",725,412,170,242,1,95,3,92,211,201,10,6
"E01006699",2011,"Liverpool 014A","Total",777,173,91,82,0,479,111,368,112,103,9,13
"E01006700",2011,"Liverpool 012E","Total",653,275,134,141,0,167,14,153,205,198,7,6
"E01006701",2011,"Liverpool 014B","Total",671,360,168,192,5,188,34,154,110,103,7,8
"E01006702",2011,"Liverpool 014C","Total",740,274,142,132,6,301,47,254,150,140,10,9
"E01006703",2011,"Liverpool 014D","Total",818,225,107,118,8,458,120,338,120,111,9,7
"E01006705",2011,"Liverpool 009E","Total",689,338,135,203,1,60,1,59,277,262,15,13
"E01006706",2011,"Liverpool 045A","Total",582,186,100,86,1,360,62,298,29,25,4,6
"E01006707",2011,"Liverpool 045B","Total",553,213,115,98,1,316,74,242,18,17,1,5
"E01006708",2011,"Liverpool 045C","Total",754,383,121,262,28,275,32,243,57,44,13,11
"E01006709",2011,"Liverpool 040A","Total",685,307,119,188,22,314,44,270,34,27,7,8
"E01006710",2011,"Liverpool 045D","Total",592,411,192,219,2,70,11,59,106,102,4,3
"E01006711",2011,"Liverpool 027A","Total",685,339,146,193,2,129,8,121,197,172,25,18
"E01006712",2011,"Liverpool 029D","Total",569,367,159,208,1,34,7,27,161,155,6,6
"E01006713",2011,"Liverpool 029E","Total",604,435,208,227,0,19,1,18,147,137,10,3
"E01006716",2011,"Liverpool 032E","Total",701,323,136,187,1,167,18,149,203,188,15,7
"E01006717",2011,"Liverpool 027D","Total",576,441,207,234,0,17,1,16,110,103,7,8
"E01006718",2011,"Liverpool 027E","Total",678,446,198,248,2,100,3,97,119,114,5,11
"E01006719",2011,"Liverpool 027F","Total",638,430,196,234,2,51,16,35,149,136,13,6
"E01006720",2011,"Liverpool 035A","Total",905,216,98,118,3,269,26,243,411,393,18,6
"E01006721",2011,"Liverpool 038C","Total",912,222,94,128,9,341,27,314,331,322,9,9
"E01006722",2011,"Liverpool 038D","Total",608,215,101,114,9,42,4,38,333,308,25,9
"E01006723",2011,"Liverpool 038E","Total",749,240,137,103,5,126,11,115,374,356,18,4
"E01006724",2011,"Liverpool 038F","Total",554,242,119,123,3,44,2,42,258,246,12,7
"E01006725",2011,"Liverpool 035B","Total",739,332,160,172,0,154,11,143,244,225,19,9
"E01006726",2011,"Liverpool 035C","Total",659,258,127,131,5,117,4,113,270,257,13,9
"E01006727",2011,"Liverpool 035D","Total",665,401,169,232,2,36,4,32,217,204,13,9
"E01006728",2011,"Liverpool 035E","Total",855,243,118,125,2,295,18,277,303,294,9,12
"E01006729",2011,"Liverpool 008C","Total",539,165,79,86,2,337,83,254,24,19,5,11
"E01006730",2011,"Liverpool 011C","Total",542,244,118,126,0,269,79,190,26,21,5,3
"E01006731",2011,"Liverpool 011D","Total",486,228,93,135,1,186,54,132,61,58,3,10
"E01006732",2011,"Liverpool 011E","Total",644,62,43,19,1,552,152,400,22,21,1,7
"E01006734",2011,"Liverpool 005C","Total",625,154,70,84,0,405,93,312,55,52,3,11
"E01006735",2011,"Liverpool 005D","Total",571,218,91,127,2,290,88,202,53,47,6,8
"E01006736",2011,"Liverpool 005E","Total",582,275,118,157,0,238,74,164,60,57,3,9
"E01006737",2011,"Liverpool 005F","Total",562,256,117,139,1,253,64,189,47,41,6,5
"E01006738",2011,"Liverpool 058A","Total",662,318,153,165,0,275,55,220,65,64,1,4
"E01006739",2011,"Liverpool 058B","Total",707,209,81,128,0,433,84,349,55,42,13,10
"E01006740",2011,"Liverpool 057A","Total",604,144,64,80,1,396,53,343,58,53,5,5
"E01006741",2011,"Liverpool 058C","Total",778,364,166,198,0,345,88,257,59,54,5,10
"E01006742",2011,"Liverpool 057B","Total",591,361,137,224,2,147,27,120,76,70,6,5
"E01006743",2011,"Liverpool 058D","Total",1008,484,162,322,4,235,36,199,278,265,13,7
"E01006744",2011,"Liverpool 057C","Total",739,431,144,287,26,95,6,89,178,167,11,9
"E01006745",2011,"Liverpool 057D","Total",907,326,150,176,2,164,22,142,407,392,15,8
"E01006746",2011,"Liverpool 030E","Total",655,187,122,65,0,294,69,225,162,155,7,12
"E01006747",2011,"Liverpool 031B","Total",857,125,75,50,1,279,29,250,436,413,23,16
"E01006748",2011,"Liverpool 031C","Total",756,219,145,74,7,136,7,129,389,371,18,5
"E01006751",2011,"Liverpool 031F","Total",831,159,78,81,4,440,91,349,209,204,5,19
"E01006752",2011,"Liverpool 035F","Total",489,225,96,129,0,100,14,86,159,158,1,5
"E01006753",2011,"Liverpool 059A","Total",666,238,100,138,5,361,87,274,56,53,3,6
"E01006754",2011,"Liverpool 059B","Total",781,263,120,143,3,380,105,275,127,119,8,8
"E01006755",2011,"Liverpool 059C","Total",690,140,49,91,1,466,112,354,68,65,3,15
"E01006756",2011,"Liverpool 059D","Total",757,217,93,124,3,427,116,311,103,101,2,7
"E01006757",2011,"Liverpool 059E","Total",621,244,109,135,1,302,60,242,63,55,8,11
"E01006758",2011,"Liverpool 059F","Total",639,269,114,155,0,318,79,239,46,39,7,6
"E01006759",2011,"Liverpool 028D","Total",460,250,115,135,1,47,9,38,153,148,5,9
"E01006760",2011,"Liverpool 028E","Total",826,193,90,103,0,226,32,194,398,380,18,9
"E01006761",2011,"Liverpool 020B","Total",793,356,156,200,3,224,28,196,200,188,12,10
"E01006762",2011,"Liverpool 015E","Total",725,332,146,186,0,274,17,257,104,90,14,15
"E01006763",2011,"Liverpool 020C","Total",652,394,148,246,3,36,2,34,213,201,12,6
"E01006764",2011,"Liverpool 020D","Total",667,309,138,171,2,84,5,79,266,247,19,6
"E01006765",2011,"Liverpool 020E","Total",659,375,163,212,21,119,38,81,137,132,5,7
"E01006766",2011,"Liverpool 019E","Total",574,209,93,116,2,119,5,114,239,236,3,5
"E01006767",2011,"Liverpool 019F","Total",779,352,124,228,1,135,5,130,281,276,5,10
"E01006768",2011,"Liverpool 020F","Total",587,310,142,168,3,63,1,62,204,195,9,7
"E01006769",2011,"Liverpool 040B","Total",712,189,90,99,30,440,60,380,33,28,5,20
"E01006770",2011,"Liverpool 040C","Total",445,214,101,113,1,195,34,161,27,25,2,8
"E01006771",2011,"Liverpool 040D","Total",694,206,99,107,0,405,47,358,65,55,10,18
"E01006772",2011,"Liverpool 040E","Total",480,329,155,174,18,95,29,66,29,25,4,9
"E01006773",2011,"Liverpool 036D","Total",554,480,209,271,1,18,4,14,51,46,5,4
"E01006774",2011,"Liverpool 036E","Total",552,476,182,294,0,33,7,26,33,27,6,10
"E01006775",2011,"Liverpool 040F","Total",556,192,100,92,1,322,51,271,25,25,0,16
"E01006776",2011,"Liverpool 022B","Total",844,244,79,165,25,452,28,424,115,105,10,8
"E01006778",2011,"Liverpool 014E","Total",1124,244,123,121,7,551,154,397,307,298,9,15
"E01006779",2011,"Liverpool 022D","Total",902,177,65,112,22,620,166,454,61,53,8,22
"E01006780",2011,"Liverpool 002D","Total",619,446,192,254,0,32,4,28,133,123,10,8
"E01006781",2011,"Liverpool 003A","Total",600,511,189,322,2,28,5,23,56,48,8,3
"E01006782",2011,"Liverpool 003B","Total",691,438,184,254,0,52,6,46,195,190,5,6
"E01006783",2011,"Liverpool 002E","Total",645,439,187,252,0,30,4,26,168,164,4,8
"E01006784",2011,"Liverpool 003C","Total",586,408,155,253,2,23,3,20,149,137,12,4
"E01006785",2011,"Liverpool 003D","Total",781,451,190,261,1,46,12,34,269,264,5,14
"E01006786",2011,"Liverpool 003E","Total",764,574,237,337,0,77,18,59,105,95,10,8
"E01006787",2011,"Liverpool 006A","Total",691,280,106,174,1,109,18,91,292,283,9,9
"E01006788",2011,"Liverpool 006B","Total",681,496,197,299,0,47,13,34,131,120,11,7
"E01006790",2011,"Liverpool 006C","Total",801,209,100,109,0,389,32,357,194,187,7,9
"E01006791",2011,"Liverpool 006D","Total",873,274,105,169,1,379,99,280,198,188,10,21
"E01006792",2011,"Liverpool 046A","Total",557,479,280,199,11,37,3,34,26,22,4,4
"E01006793",2011,"Liverpool 051A","Total",759,405,234,171,1,165,20,145,177,166,11,11
"E01006794",2011,"Liverpool 046B","Total",711,511,275,236,0,38,5,33,151,141,10,11
"E01006795",2011,"Liverpool 051B","Total",628,508,248,260,0,14,3,11,95,92,3,11
"E01006796",2011,"Liverpool 047E","Total",581,539,289,250,0,6,1,5,29,29,0,7
"E01006797",2011,"Liverpool 051C","Total",707,378,171,207,1,251,57,194,62,62,0,15
"E01006798",2011,"Liverpool 051D","Total",609,515,275,240,1,22,8,14,69,64,5,2
"E01006799",2011,"Liverpool 051E","Total",1145,428,231,197,4,502,21,481,191,178,13,20
"E01006800",2011,"Liverpool 046C","Total",679,604,380,224,1,8,0,8,57,47,10,9
"E01006801",2011,"Liverpool 046D","Total",609,562,324,238,1,3,0,3,39,30,9,4
"E01032505",2011,"Liverpool 050F","Total",563,351,167,184,1,118,9,109,88,83,5,5
"E01032506",2011,"Liverpool 050G","Total",656,386,173,213,0,98,6,92,164,159,5,8
"E01032507",2011,"Liverpool 050H","Total",666,415,188,227,0,36,3,33,213,204,9,2
"E01032508",2011,"Liverpool 027G","Total",847,260,115,145,0,384,68,316,185,170,15,18
"E01032509",2011,"Liverpool 027H","Total",665,336,150,186,0,114,8,106,211,201,10,4
"E01032510",2011,"Liverpool 008F","Total",776,464,172,292,0,124,43,81,177,176,1,11
"E01032511",2011,"Liverpool 008G","Total",616,398,184,214,1,155,56,99,60,54,6,2
"E01033747",2011,"Liverpool 018F","Total",496,80,35,45,5,298,17,281,101,99,2,12
"E01033748",2011,"Liverpool 050I","Total",772,243,64,179,1,19,5,14,501,476,25,8
"E01033749",2011,"Liverpool 042F","Total",1039,65,33,32,0,228,31,197,743,223,520,3
"E01033750",2011,"Liverpool 061A","Total",905,238,82,156,1,22,1,21,629,609,20,15
"E01033751",2011,"Liverpool 062A","Total",603,197,73,124,1,134,19,115,266,256,10,5
"E01033752",2011,"Liverpool 062B","Total",790,95,25,70,2,12,1,11,673,655,18,8
"E01033753",2011,"Liverpool 062C","Total",714,80,20,60,0,8,1,7,623,609,14,3
"E01033754",2011,"Liverpool 061B","Total",838,141,58,83,1,173,25,148,514,500,14,9
"E01033755",2011,"Liverpool 062D","Total",675,140,34,106,11,14,1,13,496,486,10,14
"E01033756",2011,"Liverpool 061C","Total",733,183,97,86,5,51,1,50,486,467,19,8
"E01033757",2011,"Liverpool 037E","Total",715,33,19,14,9,343,10,333,328,315,13,2
"E01033758",2011,"Liverpool 060B","Total",475,25,12,13,1,221,27,194,225,218,7,3
"E01033759",2011,"Liverpool 010F","Total",480,206,80,126,0,192,39,153,70,64,6,12
"E01033760",2011,"Liverpool 060C","Total",529,58,16,42,10,77,6,71,378,351,27,6
"E01033761",2011,"Liverpool 060D","Total",832,69,19,50,55,53,2,51,650,629,21,5
"E01033762",2011,"Liverpool 060E","Total",456,59,24,35,3,102,10,92,290,281,9,2
"E01033763",2011,"Liverpool 031G","Total",820,108,64,44,1,476,38,438,223,208,15,12
"E01033764",2011,"Liverpool 022E","Total",1172,213,112,101,1,738,208,530,191,180,11,29
"E01033765",2011,"Liverpool 061D","Total",659,180,71,109,1,329,115,214,136,125,11,13
"E01033766",2011,"Liverpool 042G","Total",424,234,106,128,3,25,2,23,160,144,16,2
"E01033767",2011,"Liverpool 050J","Total",562,196,120,76,0,175,34,141,182,175,7,9
"E01033768",2011,"Liverpool 037F","Total",835,53,20,33,13,570,26,544,195,184,11,4
