"lsoa11cd","date","lsoa11nm","Rural Urban","Tenure: All categories: Tenure; measures: Value","Tenure: Owned: Total; measures: Value","Tenure: Owned: Owned outright; measures: Value","Tenure: Owned: Owned with a mortgage or loan; measures: Value","Tenure: Shared ownership (part owned and part rented); measures: Value","Tenure: Social rented: Total; measures: Value","Tenure: Social rented: Rented from council (Local Authority); measures: Value","Tenure: Social rented: Other social rented; measures: Value","Tenure: Private rented: Total; measures: Value","Tenure: Private rented: Private landlord or letting agency; measures: Value","Tenure: Private rented: Employer of a household member; measures: Value","Tenure: Private rented: Relative or friend of household member; measures: Value","Tenure: Private rented: Other; measures: Value","Tenure: Living rent free; measures: Value"
"E01006512",2011,"Liverpool 031A","Total",1420,264,112,152,11,333,21,312,796,747,0,16,33,16
"E01006513",2011,"Liverpool 060A","Total",1691,209,92,117,47,228,19,209,1194,1124,15,20,35,13
"E01006514",2011,"Liverpool 037A","Total",1758,190,93,97,11,739,31,708,795,623,15,17,140,23
"E01006515",2011,"Liverpool 037B","Total",1208,142,37,105,44,748,133,615,256,224,0,21,11,18
"E01006518",2011,"Liverpool 044A","Total",1630,397,180,217,29,879,90,789,293,261,0,24,8,32
"E01006519",2011,"Liverpool 056A","Total",1286,1184,476,708,1,32,8,24,68,65,0,3,0,1
"E01006520",2011,"Liverpool 043A","Total",1685,345,106,239,1,413,13,400,918,890,2,22,4,8
"E01006521",2011,"Liverpool 052A","Total",1619,780,347,433,0,324,10,314,499,481,0,12,6,16
"E01006522",2011,"Liverpool 048A","Total",1670,362,99,263,6,455,24,431,835,782,2,43,8,12
"E01006523",2011,"Liverpool 052B","Total",1473,520,180,340,14,394,6,388,535,505,0,30,0,10
"E01006524",2011,"Liverpool 048B","Total",1079,664,326,338,0,22,6,16,375,336,15,10,14,18
"E01006525",2011,"Liverpool 049A","Total",1209,1051,455,596,0,16,10,6,137,111,5,9,12,5
"E01006526",2011,"Liverpool 048C","Total",1301,1014,395,619,2,126,4,122,151,142,0,9,0,8
"E01006527",2011,"Liverpool 053A","Total",1373,896,336,560,0,295,7,288,173,159,0,12,2,9
"E01006528",2011,"Liverpool 052C","Total",1434,868,282,586,10,95,18,77,451,437,0,14,0,10
"E01006529",2011,"Liverpool 048D","Total",1304,1009,347,662,6,43,6,37,238,194,3,35,6,8
"E01006530",2011,"Liverpool 055A","Total",1428,1296,610,686,8,29,6,23,84,75,0,9,0,11
"E01006531",2011,"Liverpool 055B","Total",1455,1276,639,637,2,99,13,86,68,64,0,4,0,10
"E01006532",2011,"Liverpool 047A","Total",1554,1443,646,797,0,34,0,34,72,60,0,9,3,5
"E01006533",2011,"Liverpool 055C","Total",1355,1077,489,588,4,159,19,140,104,94,6,4,0,11
"E01006534",2011,"Liverpool 054A","Total",1542,1103,362,741,0,337,85,252,94,87,0,7,0,8
"E01006535",2011,"Liverpool 054B","Total",1550,1088,363,725,3,318,61,257,104,88,0,10,6,37
"E01006536",2011,"Liverpool 054C","Total",1848,1137,374,763,3,501,142,359,184,165,0,19,0,23
"E01006537",2011,"Liverpool 055D","Total",2257,1405,488,917,7,165,22,143,671,633,10,13,15,9
"E01006538",2011,"Liverpool 055E","Total",1318,1091,421,670,6,82,35,47,133,124,0,9,0,6
"E01006539",2011,"Liverpool 047B","Total",1403,1264,580,684,1,18,3,15,115,101,2,12,0,5
"E01006540",2011,"Liverpool 024A","Total",1485,395,146,249,3,528,40,488,523,493,1,20,9,36
"E01006541",2011,"Liverpool 015A","Total",1593,1019,383,636,2,273,57,216,287,258,0,22,7,12
"E01006542",2011,"Liverpool 018A","Total",1297,694,257,437,6,234,0,234,347,331,0,16,0,16
"E01006543",2011,"Liverpool 015B","Total",1247,1044,374,670,1,58,7,51,135,124,0,11,0,9
"E01006544",2011,"Liverpool 015C","Total",1658,487,185,302,4,845,99,746,299,286,0,13,0,23
"E01006545",2011,"Liverpool 019A","Total",1512,959,331,628,0,44,23,21,488,469,2,9,8,21
"E01006546",2011,"Liverpool 019B","Total",1319,704,310,394,3,63,12,51,532,518,0,14,0,17
"E01006547",2011,"Liverpool 019C","Total",1490,614,279,335,9,233,27,206,613,590,0,19,4,21
"E01006548",2011,"Liverpool 019D","Total",1580,721,311,410,0,195,11,184,635,595,0,30,10,29
"E01006549",2011,"Liverpool 043B","Total",1559,316,150,166,16,341,23,318,870,866,1,2,1,16
"E01006550",2011,"Liverpool 038A","Total",1595,371,136,235,10,73,0,73,1133,1093,0,40,0,8
"E01006551",2011,"Liverpool 048E","Total",1134,168,75,93,8,706,19,687,237,221,10,6,0,15
"E01006552",2011,"Liverpool 039A","Total",2027,391,191,200,46,858,63,795,699,646,13,14,26,33
"E01006553",2011,"Liverpool 042A","Total",1880,625,214,411,14,101,1,100,1124,1059,0,59,6,16
"E01006554",2011,"Liverpool 048F","Total",1670,603,223,380,4,154,4,150,907,894,0,13,0,2
"E01006556",2011,"Liverpool 039B","Total",2010,308,167,141,5,940,68,872,677,628,11,21,17,80
"E01006557",2011,"Liverpool 038B","Total",2051,457,232,225,31,74,6,68,1476,1403,0,60,13,13
"E01006558",2011,"Liverpool 018B","Total",1357,408,217,191,5,518,50,468,401,396,0,5,0,25
"E01006560",2011,"Liverpool 023A","Total",1860,343,159,184,3,1375,227,1148,126,116,0,7,3,13
"E01006562",2011,"Liverpool 018E","Total",1514,468,230,238,4,697,68,629,327,319,0,4,4,18
"E01006563",2011,"Liverpool 024B","Total",1740,247,102,145,10,1175,181,994,288,286,0,1,1,20
"E01006564",2011,"Liverpool 023B","Total",1721,1009,521,488,6,492,122,370,195,166,4,21,4,19
"E01006565",2011,"Liverpool 029A","Total",1549,1076,393,683,0,327,71,256,129,117,0,7,5,17
"E01006566",2011,"Liverpool 032A","Total",1431,1167,363,804,3,113,49,64,138,124,0,8,6,10
"E01006567",2011,"Liverpool 026A","Total",1622,841,323,518,0,571,125,446,184,175,0,9,0,26
"E01006568",2011,"Liverpool 026B","Total",1491,1106,283,823,22,195,28,167,163,142,3,15,3,5
"E01006569",2011,"Liverpool 029B","Total",1372,829,337,492,3,421,128,293,95,82,0,5,8,24
"E01006570",2011,"Liverpool 026C","Total",1463,1187,426,761,1,61,10,51,209,197,1,5,6,5
"E01006571",2011,"Liverpool 026D","Total",1438,764,259,505,21,517,123,394,129,118,0,7,4,7
"E01006572",2011,"Liverpool 025A","Total",1207,440,151,289,0,655,179,476,96,96,0,0,0,16
"E01006573",2011,"Liverpool 029C","Total",1501,730,244,486,6,390,31,359,345,328,2,9,6,30
"E01006574",2011,"Liverpool 025B","Total",1388,771,242,529,1,490,111,379,125,119,0,5,1,1
"E01006575",2011,"Liverpool 034A","Total",1289,926,374,552,9,191,77,114,153,147,0,6,0,10
"E01006576",2011,"Liverpool 034B","Total",1691,1473,467,1006,0,34,0,34,173,167,0,5,1,11
"E01006577",2011,"Liverpool 034C","Total",1503,1349,498,851,0,12,4,8,128,122,0,2,4,14
"E01006578",2011,"Liverpool 036A","Total",1380,1176,353,823,2,26,4,22,175,161,0,13,1,1
"E01006579",2011,"Liverpool 034D","Total",1643,1518,634,884,0,24,16,8,100,78,0,22,0,1
"E01006580",2011,"Liverpool 036B","Total",1331,1251,487,764,0,12,6,6,57,52,0,5,0,11
"E01006581",2011,"Liverpool 036C","Total",1559,1402,542,860,0,19,5,14,135,112,13,6,4,3
"E01006582",2011,"Liverpool 041A","Total",1630,1482,561,921,3,26,5,21,106,100,0,6,0,13
"E01006583",2011,"Liverpool 047C","Total",1255,1182,517,665,0,18,15,3,44,29,0,14,1,11
"E01006584",2011,"Liverpool 034E","Total",1393,1161,452,709,8,79,10,69,141,137,0,1,3,4
"E01006585",2011,"Liverpool 032B","Total",1354,626,220,406,0,576,177,399,118,107,0,8,3,34
"E01006586",2011,"Liverpool 032C","Total",1875,1054,339,715,17,359,62,297,416,382,0,28,6,29
"E01006587",2011,"Liverpool 032D","Total",1619,1048,368,680,19,277,12,265,271,261,0,10,0,4
"E01006588",2011,"Liverpool 042C","Total",1521,935,357,578,2,84,20,64,490,462,0,22,6,10
"E01006589",2011,"Liverpool 041B","Total",1512,1354,455,899,0,33,5,28,111,99,0,12,0,14
"E01006590",2011,"Liverpool 042D","Total",1637,892,351,541,9,68,5,63,661,633,3,25,0,7
"E01006591",2011,"Liverpool 041C","Total",1633,1139,360,779,3,22,4,18,459,432,0,21,6,10
"E01006592",2011,"Liverpool 041D","Total",1541,1329,561,768,1,23,2,21,179,177,2,0,0,9
"E01006593",2011,"Liverpool 042E","Total",1541,874,293,581,0,46,5,41,608,588,0,17,3,13
"E01006594",2011,"Liverpool 047D","Total",1405,1257,548,709,3,24,10,14,116,112,0,2,2,5
"E01006595",2011,"Liverpool 049B","Total",1745,1335,503,832,2,55,3,52,342,300,0,40,2,11
"E01006596",2011,"Liverpool 049C","Total",1451,1173,453,720,0,31,8,23,245,235,0,10,0,2
"E01006597",2011,"Liverpool 041E","Total",1639,1413,598,815,0,22,1,21,190,179,0,11,0,14
"E01006598",2011,"Liverpool 010A","Total",1361,316,118,198,0,945,202,743,93,83,0,0,10,7
"E01006599",2011,"Liverpool 010B","Total",1121,217,83,134,0,797,224,573,104,89,0,0,15,3
"E01006600",2011,"Liverpool 011A","Total",1407,767,307,460,3,486,162,324,132,125,0,5,2,19
"E01006603",2011,"Liverpool 011B","Total",1386,825,356,469,0,457,125,332,89,82,0,6,1,15
"E01006604",2011,"Liverpool 016A","Total",1367,837,296,541,5,382,158,224,127,116,0,2,9,16
"E01006605",2011,"Liverpool 016B","Total",1531,779,260,519,9,551,205,346,166,154,0,2,10,26
"E01006606",2011,"Liverpool 020A","Total",1521,932,318,614,1,308,83,225,267,249,0,14,4,13
"E01006607",2011,"Liverpool 008A","Total",1529,806,293,513,2,585,145,440,101,91,0,6,4,35
"E01006608",2011,"Liverpool 009A","Total",1213,706,259,447,28,208,21,187,264,251,0,12,1,7
"E01006609",2011,"Liverpool 009B","Total",1283,787,299,488,1,224,27,197,256,247,0,6,3,15
"E01006610",2011,"Liverpool 009C","Total",1395,662,249,413,0,422,31,391,304,295,0,2,7,7
"E01006611",2011,"Liverpool 012A","Total",1291,496,196,300,0,224,19,205,552,531,0,16,5,19
"E01006612",2011,"Liverpool 008B","Total",1495,605,214,391,8,753,247,506,113,109,0,3,1,16
"E01006613",2011,"Liverpool 009D","Total",1360,819,346,473,0,409,103,306,123,107,0,11,5,9
"E01006614",2011,"Liverpool 012B","Total",1322,702,275,427,3,187,11,176,425,410,0,11,4,5
"E01006615",2011,"Liverpool 012C","Total",1302,581,225,356,12,320,47,273,366,351,0,15,0,23
"E01006616",2011,"Liverpool 015D","Total",1428,823,284,539,22,422,117,305,148,143,0,0,5,13
"E01006617",2011,"Liverpool 021A","Total",1421,1074,394,680,1,77,15,62,249,214,11,24,0,20
"E01006618",2011,"Liverpool 016C","Total",1639,1125,418,707,8,373,108,265,122,115,0,6,1,11
"E01006619",2011,"Liverpool 021B","Total",1599,1175,476,699,0,74,16,58,330,309,1,20,0,20
"E01006620",2011,"Liverpool 021C","Total",1409,1154,454,700,0,130,14,116,112,99,0,8,5,13
"E01006621",2011,"Liverpool 021D","Total",1468,1278,512,766,0,63,13,50,112,103,0,9,0,15
"E01006622",2011,"Liverpool 021E","Total",1519,1434,522,912,0,13,3,10,64,60,0,0,4,8
"E01006623",2011,"Liverpool 013A","Total",1462,1379,536,843,0,24,5,19,51,51,0,0,0,8
"E01006624",2011,"Liverpool 013B","Total",1551,976,306,670,7,310,36,274,236,225,0,11,0,22
"E01006625",2011,"Liverpool 016D","Total",1416,1198,466,732,1,71,13,58,129,122,0,7,0,17
"E01006626",2011,"Liverpool 016E","Total",1448,1179,433,746,6,163,23,140,92,78,1,13,0,8
"E01006627",2011,"Liverpool 013C","Total",1378,1068,403,665,5,162,24,138,123,107,3,13,0,20
"E01006628",2011,"Liverpool 052D","Total",1518,1085,393,692,6,104,2,102,312,290,0,21,1,11
"E01006629",2011,"Liverpool 052E","Total",1242,832,368,464,4,200,10,190,192,183,0,7,2,14
"E01006630",2011,"Liverpool 044B","Total",1338,176,52,124,0,998,237,761,146,111,0,17,18,18
"E01006632",2011,"Liverpool 044C","Total",1842,526,202,324,40,970,104,866,294,274,0,17,3,12
"E01006633",2011,"Liverpool 050B","Total",1432,329,97,232,11,883,213,670,198,187,0,4,7,11
"E01006637",2011,"Liverpool 017A","Total",1596,495,117,378,12,868,249,619,204,178,0,25,1,17
"E01006638",2011,"Liverpool 017B","Total",1219,387,128,259,0,649,186,463,161,155,4,2,0,22
"E01006639",2011,"Liverpool 017C","Total",1509,1008,278,730,9,271,41,230,221,213,0,7,1,0
"E01006640",2011,"Liverpool 021F","Total",1880,1477,530,947,1,194,16,178,191,163,0,28,0,17
"E01006641",2011,"Liverpool 025C","Total",1640,1291,136,1155,2,110,34,76,232,206,0,26,0,5
"E01006642",2011,"Liverpool 025D","Total",1290,467,171,296,2,681,195,486,128,111,0,8,9,12
"E01006643",2011,"Liverpool 025E","Total",1822,735,222,513,0,840,245,595,228,222,3,2,1,19
"E01006644",2011,"Liverpool 017D","Total",2040,1041,308,733,0,591,143,448,389,360,0,25,4,19
"E01006645",2011,"Liverpool 017E","Total",1424,486,198,288,4,774,178,596,137,135,0,0,2,23
"E01006646",2011,"Liverpool 023C","Total",1881,374,116,258,19,998,166,832,457,439,0,18,0,33
"E01006647",2011,"Liverpool 024C","Total",1422,202,96,106,27,1102,187,915,64,56,0,3,5,27
"E01006648",2011,"Liverpool 023D","Total",2175,447,136,311,20,1022,164,858,668,636,0,12,20,18
"E01006651",2011,"Liverpool 001A","Total",1642,1479,269,1210,0,48,6,42,110,97,8,5,0,5
"E01006652",2011,"Liverpool 002A","Total",1505,1130,417,713,1,37,0,37,310,301,0,9,0,27
"E01006653",2011,"Liverpool 001B","Total",1520,913,273,640,20,396,114,282,182,169,0,12,1,9
"E01006654",2011,"Liverpool 005A","Total",1455,1050,258,792,0,152,7,145,250,237,0,13,0,3
"E01006655",2011,"Liverpool 001C","Total",1733,1054,368,686,1,407,91,316,259,196,50,4,9,12
"E01006656",2011,"Liverpool 002B","Total",1493,1088,375,713,4,56,7,49,341,315,4,19,3,4
"E01006657",2011,"Liverpool 002C","Total",1211,749,257,492,0,142,15,127,312,293,0,19,0,8
"E01006658",2011,"Liverpool 001D","Total",1300,538,210,328,0,573,200,373,173,162,0,1,10,16
"E01006659",2011,"Liverpool 005B","Total",1070,498,149,349,0,367,79,288,196,185,0,2,9,9
"E01006660",2011,"Liverpool 001E","Total",1433,851,272,579,0,411,93,318,153,140,0,8,5,18
"E01006661",2011,"Liverpool 004A","Total",1663,666,229,437,0,781,248,533,176,158,0,11,7,40
"E01006662",2011,"Liverpool 004B","Total",1633,654,204,450,14,745,176,569,187,176,0,7,4,33
"E01006663",2011,"Liverpool 004C","Total",1153,607,107,500,10,353,131,222,173,158,5,7,3,10
"E01006664",2011,"Liverpool 004D","Total",1795,750,232,518,10,644,149,495,382,369,0,13,0,9
"E01006665",2011,"Liverpool 007A","Total",1555,1313,247,1066,33,26,2,24,183,166,10,4,3,0
"E01006666",2011,"Liverpool 007B","Total",1504,1337,252,1085,30,17,0,17,105,94,0,11,0,15
"E01006667",2011,"Liverpool 007C","Total",1413,969,292,677,18,292,83,209,127,113,4,7,3,7
"E01006668",2011,"Liverpool 007D","Total",1534,1315,220,1095,24,11,3,8,182,167,1,7,7,2
"E01006669",2011,"Liverpool 004E","Total",1470,1159,217,942,21,124,27,97,157,143,0,14,0,9
"E01006670",2011,"Liverpool 007E","Total",1520,1261,343,918,3,78,15,63,173,161,0,8,4,5
"E01006671",2011,"Liverpool 013D","Total",1349,989,266,723,0,258,88,170,88,77,0,9,2,14
"E01006672",2011,"Liverpool 010E","Total",1955,748,249,499,10,947,214,733,243,233,0,9,1,7
"E01006673",2011,"Liverpool 037D","Total",1925,159,64,95,10,1241,168,1073,481,467,0,0,14,34
"E01006674",2011,"Liverpool 039C","Total",1885,302,160,142,5,1288,290,998,231,202,0,25,4,59
"E01006675",2011,"Liverpool 043C","Total",1682,296,152,144,34,528,26,502,797,741,9,39,8,27
"E01006676",2011,"Liverpool 044D","Total",1753,388,193,195,6,1006,133,873,300,266,0,18,16,53
"E01006677",2011,"Liverpool 043D","Total",993,201,110,91,2,660,76,584,116,103,0,5,8,14
"E01006678",2011,"Liverpool 044E","Total",2126,483,195,288,57,1264,192,1072,285,278,0,1,6,37
"E01006679",2011,"Liverpool 039D","Total",2184,260,148,112,21,1521,379,1142,331,288,0,10,33,51
"E01006680",2011,"Liverpool 053B","Total",1569,1446,593,853,0,40,2,38,75,75,0,0,0,8
"E01006681",2011,"Liverpool 054D","Total",1585,1080,451,629,5,288,85,203,185,163,4,12,6,27
"E01006682",2011,"Liverpool 053C","Total",1310,1225,500,725,0,6,0,6,75,69,0,6,0,4
"E01006683",2011,"Liverpool 053D","Total",1507,1408,591,817,0,31,6,25,60,60,0,0,0,8
"E01006684",2011,"Liverpool 056B","Total",2113,1626,637,989,4,22,2,20,456,430,3,19,4,5
"E01006685",2011,"Liverpool 056C","Total",1426,1171,519,652,0,25,4,21,221,210,0,10,1,9
"E01006686",2011,"Liverpool 053E","Total",1429,1293,537,756,5,19,6,13,101,93,6,2,0,11
"E01006687",2011,"Liverpool 056D","Total",1896,1391,473,918,8,278,39,239,192,175,0,15,2,27
"E01006688",2011,"Liverpool 056E","Total",1520,1066,429,637,3,106,15,91,331,297,0,29,5,14
"E01006689",2011,"Liverpool 049D","Total",1651,1404,483,921,12,53,7,46,172,157,4,11,0,10
"E01006690",2011,"Liverpool 028A","Total",1457,443,182,261,1,461,33,428,523,495,0,17,11,29
"E01006691",2011,"Liverpool 030A","Total",1488,415,213,202,13,433,23,410,593,576,0,7,10,34
"E01006692",2011,"Liverpool 028B","Total",2180,816,331,485,35,564,34,530,747,709,0,31,7,18
"E01006693",2011,"Liverpool 024D","Total",1508,518,236,282,0,785,102,683,188,176,1,7,4,17
"E01006694",2011,"Liverpool 030B","Total",1864,460,215,245,5,378,19,359,990,959,0,26,5,31
"E01006695",2011,"Liverpool 028C","Total",1814,501,184,317,1,566,41,525,694,681,0,9,4,52
"E01006696",2011,"Liverpool 030C","Total",1744,651,230,421,17,536,61,475,500,472,0,16,12,40
"E01006697",2011,"Liverpool 030D","Total",1843,649,291,358,4,308,16,292,823,788,0,30,5,59
"E01006698",2011,"Liverpool 012D","Total",1716,1014,360,654,1,237,8,229,457,436,2,14,5,7
"E01006699",2011,"Liverpool 014A","Total",1581,391,169,222,0,933,187,746,237,221,0,16,0,20
"E01006700",2011,"Liverpool 012E","Total",1410,642,258,384,0,373,26,347,382,365,0,17,0,13
"E01006701",2011,"Liverpool 014B","Total",1380,832,335,497,13,327,58,269,193,176,0,13,4,15
"E01006702",2011,"Liverpool 014C","Total",1596,600,274,326,9,632,93,539,336,310,6,10,10,19
"E01006703",2011,"Liverpool 014D","Total",1527,476,182,294,19,819,203,616,202,189,2,9,2,11
"E01006705",2011,"Liverpool 009E","Total",1409,795,267,528,2,126,3,123,465,444,0,17,4,21
"E01006706",2011,"Liverpool 045A","Total",1346,415,183,232,1,856,142,714,66,58,0,2,6,8
"E01006707",2011,"Liverpool 045B","Total",1294,477,220,257,3,761,203,558,45,43,0,0,2,8
"E01006708",2011,"Liverpool 045C","Total",1757,933,231,702,41,628,52,576,139,106,4,18,11,16
"E01006709",2011,"Liverpool 040A","Total",1438,705,219,486,54,592,87,505,74,61,0,13,0,13
"E01006710",2011,"Liverpool 045D","Total",1490,1052,401,651,4,143,23,120,285,277,0,4,4,6
"E01006711",2011,"Liverpool 027A","Total",1500,791,283,508,4,236,23,213,443,386,9,38,10,26
"E01006712",2011,"Liverpool 029D","Total",1303,833,284,549,4,89,20,69,370,358,0,12,0,7
"E01006713",2011,"Liverpool 029E","Total",1375,1004,379,625,0,36,1,35,330,313,0,17,0,5
"E01006716",2011,"Liverpool 032E","Total",1454,706,252,454,3,344,34,310,391,367,1,23,0,10
"E01006717",2011,"Liverpool 027D","Total",1436,1169,434,735,0,42,2,40,208,197,0,11,0,17
"E01006718",2011,"Liverpool 027E","Total",1584,1139,418,721,4,180,9,171,238,229,0,8,1,23
"E01006719",2011,"Liverpool 027F","Total",1535,1039,387,652,5,116,40,76,366,329,2,30,5,9
"E01006720",2011,"Liverpool 035A","Total",2108,454,158,296,9,547,53,494,1087,1047,3,22,15,11
"E01006721",2011,"Liverpool 038C","Total",1655,390,141,249,14,598,65,533,641,621,0,11,9,12
"E01006722",2011,"Liverpool 038D","Total",1793,521,192,329,26,108,13,95,1105,1035,18,47,5,33
"E01006723",2011,"Liverpool 038E","Total",1862,527,271,256,14,232,28,204,1079,1034,0,37,8,10
"E01006724",2011,"Liverpool 038F","Total",1783,567,257,310,10,126,2,124,1057,1014,0,38,5,23
"E01006725",2011,"Liverpool 035B","Total",1537,708,306,402,0,311,21,290,502,464,2,33,3,16
"E01006726",2011,"Liverpool 035C","Total",1565,557,252,305,10,229,6,223,748,716,0,32,0,21
"E01006727",2011,"Liverpool 035D","Total",1438,893,311,582,3,66,11,55,464,435,0,29,0,12
"E01006728",2011,"Liverpool 035E","Total",1620,439,193,246,4,552,48,504,600,578,0,15,7,25
"E01006729",2011,"Liverpool 008C","Total",1400,403,157,246,7,902,205,697,66,57,0,2,7,22
"E01006730",2011,"Liverpool 011C","Total",1323,616,227,389,0,621,166,455,80,67,0,5,8,6
"E01006731",2011,"Liverpool 011D","Total",1196,581,179,402,1,433,147,286,159,151,0,5,3,22
"E01006732",2011,"Liverpool 011E","Total",1643,147,94,53,2,1421,380,1041,58,56,0,0,2,15
"E01006734",2011,"Liverpool 005C","Total",1412,372,146,226,0,886,198,688,136,132,0,0,4,18
"E01006735",2011,"Liverpool 005D","Total",1309,528,176,352,3,667,198,469,100,88,0,5,7,11
"E01006736",2011,"Liverpool 005E","Total",1460,694,259,435,0,587,175,412,164,157,0,7,0,15
"E01006737",2011,"Liverpool 005F","Total",1435,639,223,416,3,670,159,511,116,102,0,12,2,7
"E01006738",2011,"Liverpool 058A","Total",1501,721,275,446,0,620,125,495,154,153,0,0,1,6
"E01006739",2011,"Liverpool 058B","Total",1738,507,147,360,0,1072,189,883,143,114,1,19,9,16
"E01006740",2011,"Liverpool 057A","Total",1280,288,116,172,2,801,108,693,175,161,0,14,0,14
"E01006741",2011,"Liverpool 058C","Total",1815,886,301,585,0,763,185,578,153,146,0,7,0,13
"E01006742",2011,"Liverpool 057B","Total",1394,895,274,621,6,324,59,265,161,151,0,7,3,8
"E01006743",2011,"Liverpool 058D","Total",2175,1123,279,844,5,508,68,440,530,510,2,16,2,9
"E01006744",2011,"Liverpool 057C","Total",1482,901,250,651,34,208,22,186,323,305,0,15,3,16
"E01006745",2011,"Liverpool 057D","Total",1854,789,317,472,2,365,48,317,687,660,0,19,8,11
"E01006746",2011,"Liverpool 030E","Total",1506,406,215,191,0,623,138,485,460,439,0,19,2,17
"E01006747",2011,"Liverpool 031B","Total",1655,227,120,107,6,506,61,445,888,849,8,17,14,28
"E01006748",2011,"Liverpool 031C","Total",1936,439,245,194,21,353,15,338,1110,1058,7,35,10,13
"E01006751",2011,"Liverpool 031F","Total",2043,417,173,244,14,982,233,749,590,573,1,0,16,40
"E01006752",2011,"Liverpool 035F","Total",1012,502,195,307,0,181,23,158,322,321,0,0,1,7
"E01006753",2011,"Liverpool 059A","Total",1557,559,178,381,7,832,182,650,151,146,0,5,0,8
"E01006754",2011,"Liverpool 059B","Total",1627,621,236,385,5,732,209,523,257,242,0,6,9,12
"E01006755",2011,"Liverpool 059C","Total",1552,339,84,255,2,1015,266,749,165,158,0,3,4,31
"E01006756",2011,"Liverpool 059D","Total",1820,533,178,355,6,1023,254,769,241,239,0,0,2,17
"E01006757",2011,"Liverpool 059E","Total",1491,574,204,370,1,738,131,607,161,140,0,17,4,17
"E01006758",2011,"Liverpool 059F","Total",1527,644,187,457,0,773,175,598,101,90,0,7,4,9
"E01006759",2011,"Liverpool 028D","Total",1052,650,257,393,2,91,23,68,292,282,0,10,0,17
"E01006760",2011,"Liverpool 028E","Total",1548,488,197,291,0,307,35,272,736,700,6,17,13,17
"E01006761",2011,"Liverpool 020B","Total",1583,835,293,542,11,344,39,305,375,354,2,19,0,18
"E01006762",2011,"Liverpool 015E","Total",1692,785,292,493,0,681,49,632,204,186,0,9,9,22
"E01006763",2011,"Liverpool 020C","Total",1471,930,285,645,6,63,4,59,456,440,1,14,1,16
"E01006764",2011,"Liverpool 020D","Total",1522,792,301,491,10,170,18,152,541,510,4,18,9,9
"E01006765",2011,"Liverpool 020E","Total",1468,886,301,585,32,217,66,151,326,310,0,16,0,7
"E01006766",2011,"Liverpool 019E","Total",1265,488,181,307,7,275,10,265,480,474,0,3,3,15
"E01006767",2011,"Liverpool 019F","Total",1784,847,241,606,5,293,12,281,618,608,1,8,1,21
"E01006768",2011,"Liverpool 020F","Total",1347,838,317,521,5,125,9,116,362,343,2,16,1,17
"E01006769",2011,"Liverpool 040B","Total",1270,413,153,260,53,712,115,597,67,61,0,4,2,25
"E01006770",2011,"Liverpool 040C","Total",1002,521,200,321,1,406,68,338,62,59,0,3,0,12
"E01006771",2011,"Liverpool 040D","Total",1425,459,184,275,0,814,103,711,128,115,0,11,2,24
"E01006772",2011,"Liverpool 040E","Total",1081,776,294,482,21,202,49,153,70,60,0,3,7,12
"E01006773",2011,"Liverpool 036D","Total",1378,1220,435,785,2,37,10,27,114,104,0,10,0,5
"E01006774",2011,"Liverpool 036E","Total",1445,1272,395,877,0,73,19,54,76,66,0,10,0,24
"E01006775",2011,"Liverpool 040F","Total",1302,442,206,236,2,765,114,651,65,65,0,0,0,28
"E01006776",2011,"Liverpool 022B","Total",1646,502,135,367,54,874,53,821,204,185,0,14,5,12
"E01006778",2011,"Liverpool 014E","Total",2205,525,233,292,11,1073,323,750,570,551,8,9,2,26
"E01006779",2011,"Liverpool 022D","Total",1934,431,141,290,35,1322,348,974,115,101,0,6,8,31
"E01006780",2011,"Liverpool 002D","Total",1465,1116,390,726,0,58,10,48,280,258,0,22,0,11
"E01006781",2011,"Liverpool 003A","Total",1469,1271,377,894,8,56,10,46,129,113,0,12,4,5
"E01006782",2011,"Liverpool 003B","Total",1541,1049,358,691,0,81,12,69,399,390,0,9,0,12
"E01006783",2011,"Liverpool 002E","Total",1548,1117,369,748,0,59,11,48,359,349,0,10,0,13
"E01006784",2011,"Liverpool 003C","Total",1344,1006,320,686,4,54,11,43,270,250,0,18,2,10
"E01006785",2011,"Liverpool 003D","Total",1769,1135,389,746,4,98,29,69,511,499,0,12,0,21
"E01006786",2011,"Liverpool 003E","Total",1820,1454,484,970,0,107,19,88,241,218,0,17,6,18
"E01006787",2011,"Liverpool 006A","Total",1534,779,233,546,1,202,32,170,536,518,0,14,4,16
"E01006788",2011,"Liverpool 006B","Total",1825,1296,404,892,0,141,41,100,376,346,0,30,0,12
"E01006790",2011,"Liverpool 006C","Total",1587,445,168,277,0,776,73,703,354,342,2,6,4,12
"E01006791",2011,"Liverpool 006D","Total",1674,573,176,397,1,715,182,533,353,332,5,9,7,32
"E01006792",2011,"Liverpool 046A","Total",1364,1215,602,613,18,56,4,52,71,60,6,5,0,4
"E01006793",2011,"Liverpool 051A","Total",1494,876,432,444,1,296,34,262,309,296,2,11,0,12
"E01006794",2011,"Liverpool 046B","Total",1590,1191,545,646,0,97,15,82,276,258,4,11,3,26
"E01006795",2011,"Liverpool 051B","Total",1407,1185,472,713,0,28,3,25,180,174,0,6,0,14
"E01006796",2011,"Liverpool 047E","Total",1586,1452,624,828,0,23,4,19,101,101,0,0,0,10
"E01006797",2011,"Liverpool 051C","Total",1499,907,305,602,4,431,116,315,132,132,0,0,0,25
"E01006798",2011,"Liverpool 051D","Total",1410,1202,537,665,2,55,18,37,149,140,2,7,0,2
"E01006799",2011,"Liverpool 051E","Total",1796,774,352,422,5,651,37,614,342,310,0,21,11,24
"E01006800",2011,"Liverpool 046C","Total",1401,1264,670,594,1,17,0,17,105,89,2,14,0,14
"E01006801",2011,"Liverpool 046D","Total",1344,1245,611,634,1,8,0,8,81,66,0,15,0,9
"E01032505",2011,"Liverpool 050F","Total",1315,822,308,514,1,283,20,263,197,188,0,9,0,12
"E01032506",2011,"Liverpool 050G","Total",1344,822,326,496,0,174,11,163,338,328,0,5,5,10
"E01032507",2011,"Liverpool 050H","Total",1539,955,402,553,0,80,4,76,498,475,2,21,0,6
"E01032508",2011,"Liverpool 027G","Total",1723,618,208,410,0,751,147,604,322,304,1,11,6,32
"E01032509",2011,"Liverpool 027H","Total",1432,738,280,458,0,247,16,231,440,421,0,17,2,7
"E01032510",2011,"Liverpool 008F","Total",1809,1148,343,805,0,313,112,201,332,330,0,2,0,16
"E01032511",2011,"Liverpool 008G","Total",1378,905,346,559,5,354,121,233,112,99,0,9,4,2
"E01033747",2011,"Liverpool 018F","Total",1035,196,69,127,14,617,34,583,189,184,0,5,0,19
"E01033748",2011,"Liverpool 050I","Total",1276,397,106,291,2,37,13,24,828,794,0,32,2,12
"E01033749",2011,"Liverpool 042F","Total",1151,126,50,76,0,248,31,217,771,244,2,8,517,6
"E01033750",2011,"Liverpool 061A","Total",1448,370,126,244,1,34,1,33,1021,990,0,30,1,22
"E01033751",2011,"Liverpool 062A","Total",1039,328,127,201,1,271,40,231,433,417,0,15,1,6
"E01033752",2011,"Liverpool 062B","Total",1195,157,41,116,3,15,1,14,1010,981,6,15,8,10
"E01033753",2011,"Liverpool 062C","Total",1051,113,24,89,0,13,2,11,918,896,1,9,12,7
"E01033754",2011,"Liverpool 061B","Total",1448,242,87,155,1,325,40,285,867,841,2,20,4,13
"E01033755",2011,"Liverpool 062D","Total",1082,203,46,157,16,23,3,20,821,804,1,16,0,19
"E01033756",2011,"Liverpool 061C","Total",1136,273,139,134,5,86,2,84,756,731,0,9,16,16
"E01033757",2011,"Liverpool 037E","Total",1015,50,23,27,12,463,14,449,488,467,4,0,17,2
"E01033758",2011,"Liverpool 060B","Total",703,42,20,22,2,317,41,276,338,328,1,2,7,4
"E01033759",2011,"Liverpool 010F","Total",1147,509,152,357,0,448,116,332,173,159,0,6,8,17
"E01033760",2011,"Liverpool 060C","Total",856,88,28,60,13,120,9,111,628,577,0,12,39,7
"E01033761",2011,"Liverpool 060D","Total",1340,100,30,70,75,79,2,77,1080,1049,3,23,5,6
"E01033762",2011,"Liverpool 060E","Total",722,73,31,42,3,178,17,161,466,455,0,3,8,2
"E01033763",2011,"Liverpool 031G","Total",1471,249,156,93,1,756,51,705,453,432,0,12,9,12
"E01033764",2011,"Liverpool 022E","Total",2191,468,212,256,1,1343,381,962,330,312,3,5,10,49
"E01033765",2011,"Liverpool 061D","Total",1351,360,115,245,2,748,262,486,222,209,2,5,6,19
"E01033766",2011,"Liverpool 042G","Total",1072,510,214,296,11,60,8,52,487,447,0,36,4,4
"E01033767",2011,"Liverpool 050J","Total",1067,375,215,160,0,328,69,259,346,331,0,10,5,18
"E01033768",2011,"Liverpool 037F","Total",1219,120,43,77,26,758,31,727,310,285,0,20,5,5
